%%%%%%%%%%%%%%%%%%%%
%    %     .  %    %
% %% % %%%%%% % %% %
% %              % %
% % %% %%  %% %% % %
%  .   %    %      %
% % %% %%%%%% %% % %
% %              % %
% %% % %%%%%% % %% %
%    %   P    %    %
%%%%%%%%%%%%%%%%%%%%
